[31mError: doesnt have acccess at line : 10
 [0m------------	Scope #0	------------
print	[LIBFUNC]	(line 0) (scope 0)
input	[LIBFUNC]	(line 0) (scope 0)
objectmemberkeys	[LIBFUNC]	(line 0) (scope 0)
objecttotalmembers	[LIBFUNC]	(line 0) (scope 0)
objectcopy	[LIBFUNC]	(line 0) (scope 0)
totalarguments	[LIBFUNC]	(line 0) (scope 0)
argument	[LIBFUNC]	(line 0) (scope 0)
typeof	[LIBFUNC]	(line 0) (scope 0)
strtonum	[LIBFUNC]	(line 0) (scope 0)
sqrt	[LIBFUNC]	(line 0) (scope 0)
cos	[LIBFUNC]	(line 0) (scope 0)
sin	[LIBFUNC]	(line 0) (scope 0)
------------	Scope #1	------------
No symbols found in this scope.
------------	Scope #2	------------
x	[LOCALVAR]	(line 4) (scope 2)
a	[USERFUNC]	(line 6) (scope 2)
------------	Scope #3	------------
b	[USERFUNC]	(line 8) (scope 3)
c	[USERFUNC]	(line 13) (scope 3)